e=4 4 4 4
r=0 4 4 4
c=0 4 8 4
3=4 0 4 8
4=0 0 4 8
d=4 0 4 4
f=0 0 4 4
v=0 0 8 4
g=3 0 5 5
h=0 0 5 5
y=0 3 5 5
t=3 3 5 5
1=0 0 4 8
2=4 0 4 8
z=0 0 8 4
x=0 4 8 4
{=-3 0 5 5
}=0 0 5 5
8=0 4 4 4
7=4 4 4 4
i=0 0 4 4
u=4 0 4 4
m= 0 0 5 5
,=3 0 5 5
j=0 3 5 5
k=3 3 5 5
a=0 4 4 4
w=4 0 4 4
q=0 0 4 4
s=4 4 4 4
p=0 4 4 4
;=0 0 4 4
o=4 4 4 4
l=4 0 4 4
[=0 4 8 4
]=0 4 8 4
\ =0 0 0 0
.=0 0 0 0
O=0 0 0 0